1111111111111111111111111111
1E0010C0000C000C0001100C1001
1000111000010101000000000001
1P00000000000000000110001001
1000100010010001000000000001
100C0000000000000000C0000001
1111111111111111111111111111