1111111111111111111111111111
1E0010C0000C000C0001100C1001
1000111000010101000010000001
1000000000000000000C00000001
1000100010010001000110001001
1P0C0000000C00000000C0000001
1111111111111111111111111111